
=====================================================================
Apple - Site Map
=====================================================================
  
  	       
    	      
    	     
  	  	 
 
About Apple
* Contacting Apple — Phone Numbers | Website Feedback | International Sites   
* Investor Relations — Stock Info | Earnings Releases | Calendar   
* Job Opportunities — College | Internships | Benefits   
* Legal Information — Privacy Information   
* Public Relations — Contacts | Exec Bios | Press Release Library   
* Where to Buy — Apple Store Online | Retail Stores | Find a Reseller | Resource Locator   
* Additional Info — Accessibility | Environment | Ergonomics | Supplier Diversity | Web Badges  
 
News & Events
* eNews — Subscribe | Current eNews | eNews Schedule   
* Hot News   
* Additional Info — Macintosh Products Guide | Seminars & Events | User Groups  
 
Switch
* Switch — Why Switch? | Questions | Real Stories | Press | How to Switch | How to Buy  
 
iPod + iTunes
* iTunes — Free Download | Jukebox | Import Music | Create Playlists | Share Music | Burn CDs | Sync with iPod   
* iTunes Music Store — Free Download | Easy to Buy | Discover Music | Share your Music | Audiobooks | iTunes Link Maker     
* iPod — Tech Specs | Music and More | Accessories | Sync Your Music   
* iPod mini — Tech Specs | Music and More | Accessories | Sync Your Music   
* iPod shuffle — Tech Specs | Music to Go | Accessories | Shuffle Your Music   
* iPod photo — Tech Specs | Music and More | Accessories | Sync Your Photos | Sync Your Music   
* iPod Special Edition — Tech Specs | Music and More | Accessories | Sync Your Music  
 
Hardware Products
* AirPort Express — Tech Specs | AirTunes | Unwire Your Living Room | On the Go   
* AirPort Extreme — Tech Specs | Wireless Hotspots | At Home | On Campus   
* Displays — Tech Specs | Design | Technology | Digital | Environment   
* eMac — Tech Specs | G4 Processor | SuperDrive | Graphics | Software   
* iBook — Specs | Processor | Graphics | Wireless | Software   
* iMac — Tech Specs | G5 Processor | Design | Widescreen Graphics | Software   
* Mac mini — Tech Specs | Design | Accessories | Graphics | Software   
* PowerBook G4 — Tech Specs | Solutions | SuperDrive | Graphics | Wireless | Software   
* PowerPC G5 Processor — Architecture | Execution Core | IBM Fabrication Process | Power Mac G5 | Xserve G5 | iMac G5   
* Power Mac G5 — Tech Specs | Architecture | G5 Processor | Performance | Expansion | Design | Graphics | Solutions   
* Xserve G5 — Tech Specs | Architecture | G5 Processor | Performance | Design | Cluster | Management | Support   
* Xserve RAID — Tech Specs | Architecture | Performance | Fiber Channel | Management | Deployment | Certifications | Support   
* Hardware Technologies — Bluetooth | FireWire | USB   
* Additional Product Info — Commercials | QTVR Gallery | Product Promotions  
 
Software Products
* Apple Remote Desktop — Tech Specs | In the Classroom | At Work   
* AppleScript — Learn AppleScript | Help & Examples | Free Scripts | Scriptable Apps | Mac OS X | Developers   
* AppleWorks — Specs | Newsletter | Party Planning | Garage Sale | Resume | Science Report | Extras & User Groups   
* DVD Studio Pro — Tech Specs | Feature Overview | Stories | Resources | Training | Resellers | Quick Tour     
* Final Cut Express HD — Feature Overview | Live Type | Soundtrack | Tech Specs | Training | Resources   
* Final Cut Pro — Tech Specs | Overview | Stories | Resources | Training | Resellers | Quick Tour   
* GarageBand — Explore GarageBand | Play | Loops | Record | Mix | Jam Packs | Accessories     
* iCal — Free Download | Organize your Calendars | Share Online | Calendar Library   
* iChat — iSight   
* iDVD — Explore iDVD | Themes | Feature Overview | Scene Selection | Slideshows   
* iLife '05 — iPhoto 5 | iMovie HD | iDVD 5 | GarageBand 2 | iTunes 4.7   
* iMovie — Explore iMovie HD | Importing | Magic iMovie | Editing | Video Effects | Sound Effects | Sharing     
* iPhoto — Explor iPhoto | Importing | Organize | Editing | Slideshows | Share Online | Prints | Make a BookiSync — Free Download | How iSync Works | Tips and Tricks | Feedback   
* iWork — Keynote | Pages   
* Logic — Tech Specs | Feature Overview | Stories | Resources | Training | Resellers   
* Logic Express — Tech Specs | Feature Comparison | Resources   
* Mac OS X — Tiger Preview | New Features | Overview | Architecture | Developer Tools | Tech Specs | Upgrade | Hot Apps | Downloads   
* Motion — Tech Specs | Feature Overview | Resources | Training | Resellers   
* Mac OS X Server — Tech Specs | File and Print | Web Server | Desktop Management | Media Streaming | Cluster Computing   
* Safari — Download Safari   
* Shake — Tech Specs | Feature Overview | Stories | Resources | Training | Resellers | Quick Tour   
* WebObjects — Tech Specs | Getting Started | Web Services | Developer | Resources   
* Xsan — Tech Specs | Video Workflow | Data Center | High Performance Computing | Management | Compatibility   
* Software Technologies — Digital Video | DVD | Java | OpenGL | Speech  
  
Pro Digital Production
* Products — Final Cut Pro | Motion | DVD Studio Pro | Shake | Logic | Logic Express   
* Additional Info — Resources | Training | Stories  
 
QuickTime
* Products — QuickTime | Why QuickTime | Streaming Server | Broadcaster | Tools & Tips | Services   
* QuickTime 6 — Web Installer | Full Installer | MPEG-4 | QuickTime VR | FAQ | Feedback   
* Movie Trailers — New Releases | Studios | Games Trailers   
* What’s On — Music | Education | Trailers | Games Trailers | News | Entertainment   
* Additional Info — Developer Info | QuickTime Support | Logos & Licensing  
 
The Apple Store
* Apple Stores — Online | Apple store locations   
* Desktops & Portables — eMac | iBook | New iMac | iMac | PowerBook G4 | Power Mac G5   
* Server —  | Xserve G5 | Xserve RAID | Mac OS X Server (10-Client) | Mac OS X Server (Unlimited-Client)   
* Displays — 30" Cinema HD Display | 23" Cinema HD Display | 20" Cinema Display   
* Digital & Wireless Devices — AirPort | iPod | iPod mini | iSight | Accessories   
* Interests — Business | Government | Photos | Music | Movies | Switch   
* Software — AppleWorks | DVD Studio Pro | Final Cut Pro | iLife | Keynote | Mac OS X Panther | WebObjects   
* AppleCare — Protection Plan | Professional Support | Technician Training   
* Additional Info — Apple Store for Education | Worldwide | Loans & Leasing | Find a Reseller  
 
Support
* AppleCare Products — Overview | Protection Plan | Tech Training | Support Tools | SupportLine & Tools   
* Online Support — Knowledge Base | Knowledge Base Archive | Discussions | Software Downloads | Apple Specs | Manuals   
* Service & Repairs — Repair Service | SupportLine | Professional SupportLine | Pro Video SupportLine | Premium Service and Support   
* Apple Consultants Network — Find a Consultant | Learn from a Trainer | Seminars & Events   
* Apple Professional Services — Consulting | Setup & Installation | Technician Training | Technician Support   
* Additional Info — Product Registration | Support Feedback  
 
.Mac
* .Mac — Email | HomePage | iCards | iDisk  
 
Developer
* Apple Developer Connection — Membership Info | Technical Info | Business Opportunities   
* Additional Info — Student Developers | Developer Contacts  
 
Market Areas
* Business — Accounting & Finance | General Productivity | Marketing & Sales | Data & Networking | Mobile & Wireless | Online Business       
* Education — K-12 | Higher Ed | eMac | The Apple Store | PowerSchool | Digital Hub | Apple Learning Interchange   
* Federal — How to Buy | Accessibility | User Groups   
* Games — Getting Started | Game Trailers | Game Hardware | Find Games | OpenGL | Developers   
* Pro — Design | Film + Video | Music + Audio | Photo | Science | Words   
* Science — Scientific Computing | Mac OS X in Science | Applications for Research | Profiles | Resources  
Site Map | Search Tips 
Visit the Apple Store online or at retail locations.
1-800-MY-APPLE
Contact Us | Terms of Use | Privacy Policy
Copyright © 2005 Apple Computer, Inc. All rights reserved.
