A { text-decoration: none;} A: HOVER { color: #000000; } 
=====================================================================
FAQ : HURRICANES, TYPHOONS, AND TROPICAL CYCLONES
=====================================================================
 
 Hurricane FAQ
  Atl. TC Outlook
  Storm Shutters
  Weather Room
  Current Weather
  Hurr. Awareness 
National Hurricane Center 
NOAA Aircraft Operations Center 	
Site Map
Staff	 Data Center	 Contact  Information	 Research Divisions
---------------------------------------------------------------------
Back to Tropical Cyclones Names Page | Back to Main FAQ Page 
Subject: B2) What are the upcoming tropical cyclone names ? 
NORTHERN HEMISPHERE TROPICAL CYCLONE NAMES
 (Courtesy of Gary Padgett, Jack Beven and James Lewis Free)
Atlantic, Gulf of Mexico, Caribbean Sea 
2002	2003	2004	2005	2006	2007	2008	 
Arthur	Ana	Alex	Arlene	Alberto	Andrea	Arthur	 
Bertha	Bill	Bonnie	Bret	Beryl	Barry	Bertha	 
Cristobal	Claudette	Charley	Cindy	Chris	Chantal	Cristobal	 
Dolly	Danny	Danielle	Dennis	Debby	Dean	Dolly	 
Edouard	Erika	Earl	Emily	Ernesto	Erin	Edouard	 
Fay	Fabian	Frances	Franklin	Florence	Felix	Fay	 
Gustav	Grace	Gaston	Gert	Gordon	Gabrielle	Gustav	 
Hanna	Henri	Hermine	Harvey	Helene	Humberto	Hanna	 
Isidore	Isabel	Ivan	Irene	Isaac	Ingrid	Ike	 
Josephine	Juan	Jeanne	Jose	Joyce	Jerry	Josephine	 
Kyle	Kate	Karl	Katrina	Kirk	Karen	Kyle	 
Lili	Larry	Lisa	Lee	Leslie	Lorenzo	(Laura)	 
Marco	Mindy	Matthew	Maria	Michael	Melissa	Marco	 
Nana	Nicholas	Nicole	Nate	Nadine	Noel	Nana	 
Omar	Odette	Otto	Ophelia	Oscar	Olga	Omar	 
Paloma	Peter	Paula	Philippe	Patty	Pablo	Paloma	 
Rene	Rose	Richard	Rita	Rafael	Rebekah	Rene	 
Sally	Sam	Shary	Stan	Sandy	Sebastien	Sally	 
Teddy	Teresa	Tomas	Tammy	Tony	Tanya	Teddy	 
Vicky	Victor	Virginie	Vince	Valerie	Van	Vicky	 
Wilfred	Wanda	Walter	Wilma	William	Wendy	Wilfred	 
Name Used
Subtropical storm
 
---------------------------------------------------------------------
Eastern North Pacific (east of 140W) 
2002	2003	2004	2005	2006	2007	 
Alma	Andres	Agatha	Adrian	Aletta	Adolph	 
Boris	Blanca	Blas	Beatriz	Bud	Barbara	 
Cristina	Carlos	Celia	Calvin	Carlotta	Cosme	 
Douglas	Dolores	Darby	Dora	Daniel	Dalila	 
Elida	Enrique	Estelle	Eugene	Emilia	Erick	 
Fausto	Felicia	Frank	Fernanda	Fabio	Flossie	 
Genevieve	Guillermo	Georgette	Greg	Gilma	Gil	 
Hernan	Hilda	Howard	Hilary	Hector	Henriette	 
Iselle	Ignacio	Isis	Irwin	Ileana	Israel	 
Julio	Jimena	Javier	Jova	John	Juliette	 
Kenna	Kevin	Kay	Kenneth	Kristy	Kiko	 
Lowell	Linda	Lester	Lidia	Lane	Lorena	 
Marie	Marty	Madeline	Max	Miriam	Manuel	 
Norbert	Nora	Newton	Norma	Norman	Narda	 
Odile	Olaf	Orlene	Otis	Olivia	Octave	 
Polo	Patricia	Paine	Pilar	Paul	Priscilla	 
Rachel	Rick	Roslyn	Ramon	Rosa	Raymond	 
Simon	Sandra	Seymour	Selma	Sergio	Sonia	 
Trudy	Terry	Tina	Todd	Tara	Tico	 
Vance	Vivian	Virgil	Veronica	Vicente	Velma	 
Winnie	Waldo	Winifred	Wiley	Willa	Wallis	 
Xavier	Xina	Xavier	Xina	Xavier	Xina	 
Yolanda	York	Yolanda	York	Yolanda	York	 
Zeke	Zelda	Zeke	Zelda	Zeke	Zelda	 
Name Used
(The 2008 names will be identical to the list for 2002.) 
---------------------------------------------------------------------
Central North Pacific (from the dateline to 140W) 
Alika	Ana	Akoni	Aka	 
Ele	Ela	Ema	Ekeka	 
Huko	Halola	Hana	Hali	 
Ioke	Iune	Io	Iolana	 
Kika	Kimo	Keli	Keoni	 
Lana	Loke	Lala	Li	 
Maka	Malia	Moke	Mele	 
Neki	Niala	Nele	Nona	 
Oleka	Oko	Oka	Oliwa	 
Peni	Pali	Peke	Paka	 
Ulia	Ulika	Uleki	Upana	 
Wali	Walaka	Wila	Wene	 
Used in 2002
Each year the next name is just the one following the last from the previous year. Once through a list the next name will be off of the top of the next list. 
---------------------------------------------------------------------
TROPICAL CYCLONE NAMES
for the
NORTHWEST PACIFIC
From: Gary Padgett
For over a half-century (since at least 1945) the military weather forecasters, initially members of the U. S. Navy and later also from the U. S. Air Force, have named tropical cyclones forming in the Northwest Pacific basin. The names utilized were almost exclusively English feminine names through 1978, but beginning in 1979 men's names were used with women's names in an alternating fashion. Also, starting in 1963 the meteorological service of the Philippines (now known as PAGASA) began assigning Filipino women's names ending in "ng" to tropical depressions and cyclones forming in or passing through PAGASA's area of warning responsibility. In 2002 a new naming scheme was adopted by PAGASA (see below). 
Beginning on 1 January 2000, tropical cyclones in the Northwest Pacific basin are named from a new and very different list of names. The new names are Asian names and were contributed by all the nations and territories that are members of the WMO's Typhoon Committee. The new names will be allotted to developing tropical storms by the Tokyo Typhoon Centre of the Japanese Meteorological Agency which is the RSMC for the basin. 
These newly selected names have two major differences from the rest of the world's tropical cyclone name rosters. One, the names by and large are not personal names. There are a few men's and women's names, but the majority are names of flowers, animals, birds, trees, or even foods, etc, while some are descriptive adjectives. Secondly, the names will not be allotted in alphabetical order, but are arranged by contributing nation with the countries being alphabetized. Fourteen nations or territories contributed ten names each for a total of 140 names. The first 42 names on the roster are: 
Western North Pacific
(west of the dateline) 
Contributing Nation	Names	 
Cambodia	Damrey	Kong-rey	Nakri	Krovanh	Sarika	 
China	Longwang	Yutu	Fengshen	Dujuan	Haima	 
DPR Korea	Kirogi	Toraji	Kalmaegi	Maemi	Meari	 
HK, China	Kai-Tak	Man-yi	Fung-wong	Choi-wan	Ma-on	 
Japan	Tenbin	Usagi	Kanmuri	Koppu	Tokage	 
Lao PDR	Bolaven	Pabuk	Phanfone	Ketsana	Nock-ten	 
Macau	Chanchu	Wutip	Vongfong	Parma	Muifa	 
Malaysia	Jelawat	Sepat	Rusa	Melor	Merbok	 
Micronesia	Ewinlar	Fitow	Sinlaku	Nepartak	Nanmadol	 
Philippines	Bilis	Danas	Hagupit	Lupit	Talas	 
RO Korea	Gaemi	Nari	Changmi	Sudal	Noru	 
Thailand	Prapiroon	Vipa	Megkhla	Nida	Kularb	 
U.S.A.	Maria	Francisco	Higos	Omais	Roke	 
Vietnam	Saomai	Lekima	Bavi	Conson	Sonca	 
Cambodia	Bopha	Krosa	Maysak	Chanthu	Nesat	 
China	Wukong	Haiyan	Haishen	Dianmu	Haitang	 
DPR Korea	Sonamu	Podul	Pongsona	Mindule	Nalgae	 
HK, China	Shanshan	Lingling	Yanyan	Tingting	Banyan	 
Japan	Yagi	Kaziki	Kujira	Kompasu	Washi	 
Lao PDR	Xangsane	Faxai	Chan-hom	Namtheun	Matsa	 
Macau	Bebinca	Vamei	Linfa	Malou	Sanvu	 
Malaysia	Rumbia	Tapah	Nangka	Meranti	Mawar	 
Micronesia	Soulik	Mitag	Soudelor	Rananin	Guchol	 
Philippines	Cimaron	Hagibis	Imbudo	Malakas	Talim	 
RO Korea	Chebi	Noguri	Koni	Megi	Nabi	 
Thailand	Durian	Ramasoon	Hanuman	Chaba	Khanun	 
U.S.A.	Utor	Chataan	Etau	Kodo	Vicete	 
Vietnam	Trami	Halong	Vamco	Songda	Saola	 
Last used
 
PAGASA Names
Since 1963 PAGASA has independently named tropical cyclones forming in the Philippines' AOR--from 115E to 135E and from 5N to 25N (except for a portion of the northwestern corner of the above region).  Even though the Philippines contributed ten names to the international list of typhoon names, PAGASA still continues to assign their own names for local use within the Philippines.  It is felt that familiar names are more easily remembered in the rural areas and that having a PAGASA- assigned name helps to underscore the fact that the cyclone is within PAGASA's AOR and potentially a threat to the Philippines.    Another consideration may be PAGASA's desire to assign a name when a system is first classified as a tropical depression.    Since tropical and/or monsoon depressions can bring very heavy rainfall to the nation which often results in disastrous flooding, the weather service feels that assigning a name helps to enhance public attention given to a system. Beginning with 2001 PAGASA began using new sets of cyclone names.  These do not all end in "ng" as did the older names.  Four sets of 25 names will be rotated annually; thus, the set for 2002 will be re-used in 2006.   In case more than 25 systems are named in one season, an auxiliary set will be used.   PAGASA names for 2002 are (** indicates name has already been assigned in 2002): PAGASA names 
Agaton	Juan	Rapido 	
Basyang	Kaka	Sibasib 	
Caloy	Lagalag	Tagbanwa	 
Dagul	Milenyo	Usman	 
Espada	Neneng	Venus	 
Florita	Ompong	Wisik	 
Gloria	Paeng	Yayang	 
Hambalos	Quadro	Zeny	 
Inday	 
In the unlikely event that the list is exhausted, the following names would be allocated as needed:  Agila, Bagwis, Ciriaco, Diego, Elena, Forte, Gunding, Hunyango, Itoy, and Jessa. 
---------------------------------------------------------------------
North Indian Ocean 
Tropical cyclones in this region are not named. 
---------------------------------------------------------------------
SOUTHERN HEMISPHERE TROPICAL CYCLONE NAMES 
(Thanks to Julian Heming, Jack Beven, Gary Padgett, Frank Woodcock and Jon Gill.)
Southwest Indian (west of 90E) 
2000/2001	 2001/2002	 
Ando	Andre	 
Bindu	Bako	 
Charly	Cyprien	 
Dera	Dina	 
Evariste	Eddy	 
Francois	Francesca	 
Gaby	Guillaume	 
Hans	Hary	 
Idriss	Ikala	 
Jakoba	Jery	 
Kiran	Kesiny	 
Lanto	Lalita	 
Mathieu	Mirana	 
Nancy	Naly	 
Oda	Orelie	 
Premnath	Parina	 
Quirin	Quincy	 
Rakoto	Roger	 
Suzy	Solo	 
Tovo	Teddy	 
Ursula	Usha	 
Vimla	Vero	 
Wendy	Wenda	 
Xino	Xora	 
Yul	Yolande	 
Zoe	Zaza	 
---------------------------------------------------------------------
The other areas have lists which they continually rotate through i.e. don't start again from 'A' each year.
Western Australian region (90E to 125E) 
Adeline, Bertie, Clare, Daryl, Emma, Floyd, Glenda, Hubert, Isobel, Jacob, Kara, Lee, Melanie, Nicholas, Ophelia, Pancho, Rhonda, Selwyn, Tiffany, Victor, Zelia	 
Alison, Billy, Cathy, Damien, Elle, Frederic, Gwenda, Hamish, Ilsa, TBA, Kirrily, Leon, Marcia, Norman, Olga, Paul, TBA, Sam, Taryn, Vincent, Walter	 
Alex, Bessi, Chris, Dianne, Errol, Fiona, Graham, Harriet, Inigo, Jana, Ken, Linda, Monty, Nicky, Oscar, Phoebe, Sally, Tim, Vivienne, Willy	 
Northern Australian region (125E to 137E) 
Amelia, Bruno, Coral, Dominic, Esther, Ferdinand, Gretel, Hector, Irma, Jason,Kay, Laurence, Marian, Neville, Olwyn, Phil, Rachel, Sid, Tasha, Verdun, Winsome	 
Alistair, Bonnie, Craig, Debbie, Evan, Fay, George, Helen, Ira, Jasmine, Kim, Laura, Matt, Narelle, Oswald, Penny, Russell, Sandra, Trevor, Valerie, Warwick 	
Eastern Australian region (137E to 160E, south of ~10S) 
Ann, Bruce, Cecily, Dennis, Edna, Fletcher, Gillian, Sandy, Tessi, Vaughan, Wyla	 
Abigail, Bernie, Claudia, Des, Erica, Fritz, Grace, Harvey, Ingrid, Jim, Kate, Les, May, Nathen, Odette, Pierre, Rebecca, Steve, Tania, Vernon,Wendy	 
Alfred, Blanch, Charles, Denise, Ernie, Frances, Greg, Hilda, Ivan,Joyce, Kelvin, Lisa, Marcus, Nora, Owen, Polly, Richard, Sadie, Theodore, Verity,Wallace	 
---------------------------------------------------------------------
Fiji Area (160E to 120W) 
Ami	Arthur	Atu	Alan	Amos	 
Beni	Becky	Beti	Bart	Bobby	 
Cilla	Cliff	Cyril	Cora	Chris	 
Dovi	Daman	Drena	Dani	Daphne	 
Eseta	Elisa	Evan	Ella	Eva	 
Fili	Funa	Freda	Frank	Fanny	 
Gina	Gene	Gavin	Gita	Garry	 
Heta	Hettie	Hina	Hali	Helene	 
Ivy	Innis	Ian	Iris	Irene	 
Judy	Joni	June	Jo	Julie	 
Kerry	Kina	Keli	Kim	Ken	 
Lola	Lin	Lusi	Leo	Louise	 
Meena	Mick	Martin	Mona	Mike	 
Nancy	Nisha	Nute	Neil	Nat	 
Olaf	Oli	Osea	Oma	Odile	 
Percy	Prema	Pam	Paula	Pat	 
Rae	Rewa	Ron	Rita	Rene	 
Sina	Sarah	Susan	Sam	Sheila	 
Tam	Tomas	Tui	Trina	Tui	 
-	Usha	Ursala	Uka	Ula	 
Vaianu	Vania	Veli	Vicky	Victor	 
Wati	William	Wes	Walter	Wilma	 
-	Yasi	Yali	Yolande	Yalo	 
Zita	Zaka	Zuman	Zoe	Zena	 
---------------------------------------------------------------------
Papua New Guinea (140E to 160E, north of ~10S) 
Adel	Abdul	 
Epi	Emau	 
Guba	Gule	 
Ila	Igo	 
Kamo	Kamit	 
Tako	Tiogo	 
Upi	Ume	 
Back to Tropical Cyclones Names Page | Back to Main FAQ Page 	
  Disclaimer | Privacy Notice
   DOC/NOAA/AOML/HRD	 hrdwebmaster@aoml.noaa.gov  
 
