Add your site Services Terms & Conditions Check your email Search Law Library Library Catalog Send comments Washburn Law School 1st Circuit 2nd Circuit 3rd Circuit 4th Circuit 5th Circuit 6th Circuit 7th Circuit 8th Circuit 9th Circuit 10th Circuit 11th Circuit AALLNet Alabama Alaska All States Information Arizona Arkansas Archives Area Codes (US) Area Codes (Intl) Bankruptcy Bar Associations Bar Exams Books Business and Transactional Law Center Business Directory CALI California Center for Excellence in Advocacy Children and Family Law Center City Codes Colorado Commercial Sites Connecticut Course Materials Current Awareness Court Rules Courts CLE D.C. Circuit Delaware District of Columbia Directories Discussion Groups Documents E-Mail Directories Executive Law Experts/Consultants Federal Agencies Federal Circuit Federal Caselaw Federal Legislation Federal Statutes Federal Documents Florida Foreign Law Freenet Full-Text Searches Georgia Government Government Directories Graduate School Hawaii Historic Documents Humor Hytelnet Idaho Illinois Indexes Indiana International Law Investigators Iowa Judges Kansas Kansas Bankruptcy Kansas Decisions Kentucky Law Law Firms Law Jobs Law Journals Law Library Catalogs Law Listservs Law School Labs Law Professors Law Schools Law Search Engines Law Students Legal Books Legal Dictionaries Legal Forms Legal Humor Legal Indexes Legal Institutes Legal News Legal Newsletters Legal Newspapers Legal Organizations Legal Software Legal Vendors Lexis/Nexis Service Listserv Instructions Listserv Owners Listservs Local Law Louisiana Magazines Maine Maps Maryland Massachusetts Michigan Minnesota Mississippi Missouri Montana Nebraska Nevada New Hampshire New Jersey New Law Books New Mexico New York News Newsgroups Newspapers North Carolina North Dakota Ohio Oklahoma Oregon Other Law Sites Pennsylvania Police Phone Numbers Politics Post-Graduate Prelaw Students Publishers Radio Reference-Legal Request Service Research Guides Research and Writing Rhode Island Rules Search Law Full-Text Search Internet Search State Law Full-Text South Carolina South Dakota State Admin. Law State Caselaw State, Court, County Libraries State Legislation State Statutes Stock Market Street Maps Study Law Subject Index Subscriber Instructions Table of Contents Television Tennessee Texas Topeka Topical Index Travel U.S. Court of Appeals Uniform Laws United States Supreme Court Usenet News User Guides Utah Vermont Video Conferencing Virginia Washburn Centers for Excellence Washburn Law Catalog Washburn Law Library Washburn Study Abroad - Netherlands Washington West Virginia Westlaw Service Wisconsin Weather Reports Wyoming Zipcodes Contacts: Mark Folmsbee, Managing Editor, Mark.Folmsbee@washburn.edu Curtis Von Lintel, Technical Editor, curtis.vonlintel@washburn.edu Maintained by Staff of Washburn University School of Law Library © Copyright 2003 Washburn University School of Law Library   --> 

Add your site	 Services	 Terms & Conditions	 Check your email	 
Search	 Law Library	 Library Catalog	 Send comments	 

---------------------------------------------------------------------

Washburn Law School	 1st Circuit	 2nd Circuit	 
3rd Circuit	 4th Circuit	 5th Circuit	 
6th Circuit	 7th Circuit	 8th Circuit	 
9th Circuit	 10th Circuit	 11th Circuit	 
AALLNet	 Alabama	 Alaska	 
All States Information	 Arizona	 Arkansas	 
Archives	 Area Codes (US)	 Area Codes (Intl)	 
Bankruptcy	 Bar Associations	 Bar Exams	 
Books	 Business and Transactional Law Center	 Business Directory	 
CALI	 California	 Center for Excellence in Advocacy	 
Children and Family Law Center	 City Codes	 Colorado	 
Commercial Sites	 Connecticut	 Course Materials	 
Current Awareness 	Court Rules	 Courts	 
CLE	 D.C. Circuit	 Delaware	 
District of Columbia	 Directories	 Discussion Groups	 
Documents	 E-Mail Directories	 Executive Law	 
Experts/Consultants	 Federal Agencies	 Federal Circuit	 
Federal Caselaw	 Federal Legislation	 Federal Statutes	 
Federal Documents	 Florida	 Foreign Law	 
Freenet	 Full-Text Searches	 Georgia	 
Government	 Government Directories	 Graduate School	 
Hawaii	 Historic Documents	 Humor	 
Hytelnet	 Idaho	 Illinois 	
Indexes	 Indiana	 International Law	 
Investigators	 Iowa	 Judges	 
Kansas	 Kansas Bankruptcy	 Kansas Decisions	 
Kentucky	 Law	 Law Firms	 
Law Jobs	 Law Journals	 Law Library Catalogs	 
Law Listservs	 Law School Labs	 Law Professors	 
Law Schools	 Law Search Engines	 Law Students	 
Legal Books	 Legal Dictionaries	 Legal Forms	 
Legal Humor	 Legal Indexes	 Legal Institutes	 
Legal News	 Legal Newsletters	 Legal Newspapers	 
Legal Organizations	 Legal Software	 Legal Vendors	 
Lexis/Nexis Service	 Listserv Instructions	 Listserv Owners	 
Listservs	 Local Law	 Louisiana	 
Magazines	 Maine	 Maps	 
Maryland	 Massachusetts	 Michigan	 
Minnesota	 Mississippi	 Missouri	 
Montana	 Nebraska	 Nevada	 
New Hampshire	 New Jersey	 New Law Books	 
New Mexico	 New York	 News	 
Newsgroups	 Newspapers	 North Carolina	 
North Dakota	 Ohio	 Oklahoma	 
Oregon	 Other Law Sites	 Pennsylvania	 
Police	 Phone Numbers	 Politics	 
Post-Graduate 	Prelaw Students	 Publishers	 
Radio	 Reference-Legal	 Request Service	 
Research Guides	 Research and Writing	 Rhode Island	 
Rules	 Search Law Full-Text	 Search Internet	 
Search State Law Full-Text	 South Carolina	 South Dakota	 
State Admin. Law	 State Caselaw	 State, Court, County Libraries	 
State Legislation	 State Statutes	 Stock Market	 
Street Maps	 Study Law	 Subject Index	 
Subscriber Instructions	 Table of Contents	 Television	 
Tennessee	 Texas	 Topeka	 
Topical Index	 Travel	 U.S. Court of Appeals	 
Uniform Laws	 United States Supreme Court	 Usenet News	 
User Guides	 Utah	 Vermont	 
Video Conferencing	 Virginia	 Washburn Centers for Excellence	 
Washburn Law Catalog	 Washburn Law Library	 Washburn Study Abroad - Netherlands	 
Washington	 West Virginia	 Westlaw Service	 
Wisconsin	 Weather Reports	 Wyoming	 
Zipcodes	 

---------------------------------------------------------------------
Contacts:
 

Mark Folmsbee,	 Managing Editor,	 Mark.Folmsbee@washburn.edu	 

Curtis Von Lintel,	 Technical Editor,	 curtis.vonlintel@washburn.edu	 

---------------------------------------------------------------------

Maintained by Staff of Washburn University School of Law Library
 © Copyright 2003 Washburn University School of Law Library
 