

Main	 
Front Page
 Archives

Interactive	 
Readers' Letters

Services	 
Print Edition
 Palm Post
 E-mail Edition
    JPost CD-Rom
    Subscriptions
    SMS Alerts
 Classifieds
    Print Classifieds
    Study in Israel
 Charities

Information	 
About Us
    FAQs
 Feedback
 Media Kit
    Sales
 Staff Emails
 Hollinger Links
 Privacy Statement
 Copyright

 

Middle East Sites

The Jerusalem Post
www.jpost.com
   Jerusalem Post Audio
www.jpostradio.com 

The Jerusalem Post is not responsible for, nor does it endorse, the editorial content of the Web sites listed here. 

Note: Pages will open in a new browser window

Media Sites - Israeli	     
  The Jerusalem Report	   www.jrep.com	     
  Ma'ariv (Hebrew)	   www.maariv.co.il	     
  Yediot Aharonot (Hebrew)	   www.ynet.co.il	     
  Israel Radio	   www.israelradio.org	     
  Globes	   www.globes.co.il	     
  Arutz 7	   www.arutzsheva.org	     
  IMRA	   www.imra.org.il	     
  YeshaNews	   www.yeshanews.org	     
  Debka	   www.debka.com	     
  Jerusalem Newswire	   www.jnewswire.com	     
  Media Sites - Palestinian	     
  PNA	   www.pna.org	     
  Palestine Net	   www.palestine-net.com	     
  Al-Quds	   www.alquds.com	     
  Palestine Times Monthly	   www.ptimes.com	     
  Palestine Daily	   www.palestinedaily.com	     
  PNA	   www.gov.ps	     
  Assenara (Arabic)	   www.assenara.com	     
  Al-Ayyam (Arabic)	   www.al-ayyam.com	     
  Alhayat (Arabic)	   www.alhayat-j.com	     
  AIC	   www.aic.netgate.net	     
  Media Sites - Misc.	     
  Arabia.com	   www.arabia.com	     
  Aljazeera	   www.aljazeera.net	     
  Hizbollah	   www.hizbollah.org	     
  The Daily Star - Lebanon	   www.dailystar.com.lb	     
  Islamic Republic News Agency	   www.irna.com	     
  Iraq Daily	   www.iraqdaily.com	     
  Petra News - Jordan	   www.petra.gov.jo	     
  Syrian Times	   www.teshreen.com	     
  Cairo Times	   www.cairotimes.com	     
  Middle East Daily	   www.middleeastdaily.com	     
  Arabic Newspaper	   www.arabicnewspaper.com	     
  Albawaba	   www.albawaba.com	     
  State of israel	     
  Israel Defense Forces	   www.idf.il	     
  Ministry of Foreign Affairs	   www.mfa.gov.il	     
  Knesset	   www.knesset.gov.il	     
  Jewish agency	   www.jafi.org.il	     
  Judaism	     
  Orthodox Union	   www.ou.org	     
  Aish Hatorah	   www.aish.com	     
  Ohr Somayach	   www.ohr.edu	     
  United Synagauge Youth (USY)	   www.USY.org	     
  Holocaust	     
  Yad Vashem	   www.yadvashem.org.il	     
  Remember.org	   www.remember.org	     
  US Holocaust Museum	   www.ushmm.org	     
  Holocaust Echoes	   www.holocaustechoes.com	     
  Hebrew	     
  Morim	   www.morim.com	     
  Babylon	   www.babylon.com	     
  Israel Political	     
  Yisrael beteinu (Hebrew,Russian)	   www.beytenu.org.il	     
  Shinui	   www.shinui.org.il	     
  Haichud-Haleumi (Hebrew)	   www.haichud-haleumi.org.il	     
  Moledet (Hebrew)	   www.Moledet.org.il	     
  Meretz	   www.meretz.org.il	     
  Likud (Hebrew)	   www.likud.org.il	     
  Herut (Hebrew)	   www.herut.org.il	     
  Hadash (Hebrew)	   www.hadash.org.il	     
  Hamercaz (hebrew)	   www.hamercaz.org.il	     
  Gamla	   www.gamla.org.il	     
  Peace Now	   www.peacenow.org	     
  Hebron	   www.hebron.org.il	     
  Yesha	   www.yeshanet.org	     
  Zu Artzeinu	   www.manhigut.org	     
  Peres Center	   www.peres-center.org	     
  Bridges for Peace	   www.bridgesforpeace.com	     
  Yesha	   www.yesha.n3.net	     
  Womaningreen	   www.womaningreen.org	     
  Arab Political	     
  Hizballah	   www.hizballah.org	     
  Hizbullah	   www.moqawama.org	     
  Intifada Website	   www.adameer.org	     
  Organizations	     
  IPCRI	   www.ipcri.org	     
  Shalem Center	   www.shalem.org.il	     
  Magen David Adom	   www.magendavidadom.org	     
  Simon Wiesenthal Center	   www.wiesenthal.com	     
  KKL	   www.kkl.org.il	     
  Jewish Genealogy	   www.jewishgen.org	     
  ADL	   www.adl.org	     
  Camera	   www.camera.org	     
  TheTruthAboutIsrael.com	   www.thetruthaboutisrael.com	     
  ICEJ	   www.icej.org	     
  Vaad LeMa'an Zion	   www.helpingisrael.com	     
  JCPA	   www.jcpa.org	     
  JINSA	   www.jinsa.org	     
  ICT	   www.ict.org.il	     
  ICMIS	   www.mia.org.il	     
  Hadassah	   www.hadassah.org	     
  Beit New York-Jerusalem	   www.beitnyjer.org.il	     
  Israel Hasbara Committee	   www.infoisrael.net	     
  Zaka Rescue & Recovery	   www.zaka.org.il	     
  Diplomacy Club	   www.diplomacy-club.com	     
  Israeli Portals	     
  Ynet	   www.ynet.co.il	     
  Walla	   www.walla.co.il	     
  Start	   www.start.co.il	     
  Nana	   www.nana.co.il	     
  
   
---------------------------------------------------------------------
   

Suggest a Site
    To suggest a site click here   	   

© 1995 - 2004 The Jerusalem Post. All rights reserved.
 About Us | Media Kit | Advertise with Us | Subscribe | Contact Us	 
