

bOver 1500 freebies: ad freebies money freebies web freebies pet freebies graphic freebies and more on:	 

   free samples...beauty freebies...freebies for babies...craft freebies...coupon freebies...
Your 1-Stop Resource For Freebies on the Web
   clipart freebies...freebies for kids...game freebies...health freebies ...food freebies...	 

Freebies, free stuff, free samples ... all freebies break down to the same thing ... getting something for nothing. We've scoured the Web for the best free product samples, baby freebies, beauty freebies, freebies for men, women and teens, kid freebies, webmaster freebies and much more! Please Don't Forget to Bookmark Us!	 	

 Free Categories
Menu 

<><><><><><><><><> 
Top50 Free Samples 
<><><><><><><><><> 	

Top Rated Freebies	 Freebie of The Week	 Freebies Site of The Week	 Today's Freebie Special	 
New Freebies	 Almost Freebies	 Apparel Freebies	 Auto Freebies	 
Baby Freebies	 Beauty Freebies	 Book Freebies	 Business Freebies	 
Catalog Freebies	 Chat Freebies	 Christian Freebies	 Classified Ad Freebies	 
Computer Freebies	 Contests/Sweepstakes	 Coupon Freebies	 Craft Freebies	 
Education Freebies	 Entertainment Freebies	 Entrepreneur Freebies	 Family/Home Freebies	 
Food Freebies	 Font Freebies	 Free Product Trials	 Free Samples	 
Game Freebies	 Gift Freebies	 Government Freebies	 Graphic Freebies	 
Health Freebies	 Holiday Freebies	 International Freebies	 Internet Freebies	 
Investment Freebies	 Freebies For Kids	 Magazine Freebies	 Freebies For Men	 
Miscellaneous Freebies	 Make Money Freebies	 Newsletter Freebies	 Packaged Freebies	 
Paid-to-Play Freebies	 Prsnl Finance Freebies	 Pet Freebies	 Rebates/Refunds	 
Recipe Freebies	 Reference Freebies	 Sound Freebies	 Sports/Fitness Freebies	 
Sticker/Poster Freebies	 Steals & Deals	 Teacher Freebies	 Freebies For Teens	 
Webmaster Freebies	 Freebies For Women	 Other Freebies Sites	 Other Cool Links	 

Site Information
Menu 	

Site News	 About Us	 Media Kit	 Advertise With Us	 
Add a Freebie	 Link Exchange	 Contact Us	 Visitor Comments	 
Cool Partner Sites	 Freebies Tutorial	 Site Search	 Site Map	 

---------------------------------------------------------------------

Today's Freebies Special 	

---------------------------------------------------------------------

Top Rated Freebies
free samples, coupon freebies, game freebies, more... 	 

FREE Digital Camera!	 Get Totally FREE CDs and More!	 
Get a FREE Digital Camera now! This keychain-sized digital camera is so small you can take it anywhere. Capture all those picture-perfect opportunities.	 Choose from all the hottest CDs on from any music genre! Plus ... get Free CD/MP3 players too! Shipping is FREE and there are no obligations after joining!	 
FREE Grocery Coupons! Save on
 food, baby needs, cereal & more!	 FREE Credit Card
Approval Service!	 
Visit CoolSavings for FREE Grocery coupons. Save big on food, baby needs, bath & body products, cleaning supplies, cereal and much more!	 Need a credit card for your holiday shopping? Try this FREE service and you could receive cards with up to $7500 in credit regardless of your financial history!	 
Get Your FREE $20
KBToys Gift Card!	 Stop Overpaying Uncle Sam - Free
Booklet and Audio Tape!	 
Try Clever Island - for FREE and get a FREE $20.00 Toys 'R' Us gift card! Great freebie ... and just in time for the holidays too! This one won't last ... so don't delay ... get your FREE gift card today!	 65% of all American taxpayers pay more than they are required to Uncle Sam. NOW get FREE, "101 Hot Tax Tips", an easy to follow audio cassette and booklet. Order your FREE copy today!	 
FREE Gillette® Venus® Razors!	 Free Baby Magazine!	 
Try the hottest new Gillette® Venus® razors for woman complimentary while they last! Valued at about $10.00 in most retail stores ... limited supply so get yours NOW while they last!	 Get a FREE subscription to American Baby Magazine ... Customized to your week of pregnancy or your child's age ... Plus, great prizes for baby - mom and much more!	 
Get 5 Childrens books
for $2, plus a FREE gift!	 Get 100% Totally FREE
Condoms on the Internet!	 
Turn your kids on to books. Choose 5 childrens books for $2 plus a FREE gift from Childrens Book-of-the-Month Club® ... a leader in the industry. Help you turn your kids on to reading today!	  FreeCondoms.com also offers cool merchandise along with their full line of Durex Condoms-all 100% free of charge. You dont even pay for shipping! Get your FREE condoms today! U.S. only.	 
Free American Flag Decal!	 Play Free Games - Make Money!	 
Fill out their form and get a FREE American flag static cling decal. Hurry - Offer ends 2-29-04. U.S. only.	 Play free online games like progressive slots, video poker & more - Make Real Money!! Hurry - offer ends 2-28-04.	 
Get 4 FREE Mortgage Quotes ...
DON'T MISS OUT ON LOW RATES!	 Get a FREE $25 Gift Card
from ElectronicsOnUs.com!	 
This free service will allow you to receive up to 4 free mortgage quotes from nationwide lenders. Fill out the 3 minute form and get competitive rates, even if you have imperfect credit! U.S. only.	 Get a FREE $25 Gift Card today! Choose a FREE Gift Card from popular brand-named electronics retailers and shop on us today. What could be better than a FREE CD or DVD? Sign up today!	 
Free Gillette® Mach 3® Razor!	 Free Home Business Magazine!	 
Try the hottest new Gillette® Mach3® razors for men complimentary while they last! Valued at about $10.00 in most retail stores ... limited supply so get yours NOW while they last!	 Get a FREE issue of Home Business Connection Magazine. Learn over 50 little known money makers that you can operate from home & make big $$! No catches...You will not be billed - ever!	 
FREE Collegebound
Network Student Pak Offer!	 Poetry Contest - Enter for Free
To Win Cash & Prizes!	 
Get a Free copy of Collage Bound Magazine, FREE Goodie-filled Student Pak, Free Samples ... Info from Colleges, Student Loan Companies & more!	 The International Library of Poetry will award 250 prizes totaling $58,000.00 to amateur poets. Anyone can enter simply by submitting ONLY 1 original poem!	 
Get a FREE
Twister Stunt Car!	 FREE Preview of Weight Watchers®
Cookbook & FREE gift!	 
The Twister Stunt Car flips, rolls, twists, turns, and spins all by wireless remote - it even lights up as it zooms around. This hot car is this years HOTTEST toy gift ... and it's FREE!	 Enjoy a FREE preview of Weight Watchers® 5 Ingredient 15-Minute Cookbook and get Weight Watchers® Low POINT Lunches To Go FREE! No credit card required!	 
FREE Samples For
Heartburn Sufferers!	 Free Sample of
Kraft Mac & Cheese!	 
Do you suffer from heartburn? Ever hear of the little purple pill that can really help? Visit this site to get free samples and information! U.S. only.	 Everybodys favorite meal is yours for free. Get your Kraft Macaroni and Cheese today at no cost. No credit cards or purchases required.	 
Free FastWeb Scholarship Search! 	Win a FREE Sony Home Theatre!	 
Need money for college? Use FastWeb's free scholarship search to find information on more than 600,000 scholarships! It's easy and free!	 Enter to win a FREE Sony DreamSystem Home Theatre when you sign up to Prize-O-Matic.com. It's FREE, and it'll only take 30 seconds of your time.	 
Discover how to make an extra
 $200-$10,000 a month from home!	 100's of Free Information
Newsletters...Including Free Stuff!	 
Make an Extra $200-$10,000 a Month Working From Home! Start making money almost IMMEDIATELY. Get complete training and 100% team support. Free Information!	 Get FREE STUFF, hot deals, special offers and information on the topics YOU want to hear about delivered to your inbox for FREE! Select from 100's of totally free newsletter offers!	 
Get 3 FREE gifts for all
on Aboard with Thomas!	 Get the Iraqi 55 ... Most-Wanted ...
Card Deck or Poster today FREE!	 
Here comes Thomas with his loyal friends to share their Railways Adventures with your child. Climb aboard with Thomas and get two delightful hardcover books, plus 3 FREE Gifts when you join!	 Sign up today to get your FREE Iraqi ... Most-Wanted ... Card Deck or the exclusive Poster. NO credit card required and NO money out of your pocket. Hurry ... Limited supply!	 
Stratford Career Institute -
FREE Information!	 See a Movie of Your
Choice Absolutely FREE!	 
Get your career diploma at home with Stratford Career Institute. More than 52 exciting career opportunities to choose from. FREE Information!	 Movies can be expensive ... Choose a movie of your choice at your local theater for absolutely free! Sign up now and see a free movie on them!	 
Free CD - 21 Success Secrets
of Self Made Millionaires!	 FREE Software ... 
Norton SystemWorks 2003!	 
21 Success Secrets of Self-Made Millionaires will help you: Increase your income, Achieve your goals, Eliminate your debts, Realize your full potential and more. Get your FREE CD today!	 Protect your computer with a FREE version of Norton SystemWorks. Use Norton SystemWorks to  protect your computer against virus threats, optimize performance, fix problems & more!	 
Get FREE Roundtrip
Airfare for 2 Now!	 Lose Up To 30 Lbs. In 
 30-Days ... FREE!!	 
Sign up to get FREE airfare for two to the destination of your choice! Imagine taking time off from that boring job and flying to exotic locations with a spouse or friend. Don't delay - sign up NOW!	 For a limited time ... TrimlLife will give you all the support and tools you need to LOSE 30 lbs in 30 Days ... Absolutely FREE! You'll get a FREE 30 day TrimLife sample bottle & more!	 
More Top Freebies 	

---------------------------------------------------------------------

Top Rated Money Freebies
pay-to-surf, work at home... 	Top Rated Contests & Sweeps
win cash & prizes... 	
Make Money Giving
Away Free Stuff!	 Enter today to WIN 50 lbs.
of FREE LOBSTER!	 
Have a Web site? Make money just by giving away Free stuff! It's easy to get started and won't cost you a red cent. Don't let this one pass you by ... Click Here now for all the details!	 Like lobster? ... who doesn't! Fill out this sites short survey to be automatically entered for your chance to win 50 lbs. of FREE lobster! Don't delay ... enter today for your chance to win! U.S. only.	 
Make up to $10,000
working from home today!	 Win a new Dell desktop ...
or notebook Computer!	 
Start making up to $10,000 a month from home! Find out how you can use the Internet to get the extra money you need! NO computer experience necessary! 100% FREE Information!	 Register now and you could win a new Dell computer! Choose from either a brand new Dell Dimension 8250 Desktop or a Dell Inspiron 2650 Notebook. You must be at least 18 years old to register.	 
Own a Business ... Free Info!	 Win a FREE 42" Plasma TV!	 
The Money Maker Update does all of the research for you, matching you with only the perfect business opportunities that fit your needs and goals, And it's absolutely free!	 Time's running out ... Enter the "Plasma TV Sweeps" for your chance to win a 42" Plasma Television! This TV's picture and sound are so real ... you won't believe your eyes (U.S. only.)	 
FREE Information from ...
RetireSooner.com!	 WIN A FREE Digital Camera and
get FREE Product Samples!	 
Are you working your life away? RetireSooner.com can help you get your life back with its great work-at-home opportunities. Click above to get FREE information from RetireSooner.com!	 Enter to WIN A FREE Digital Camera and get access to loads of FREE Product Samples too! BONUS: Get FREE product samples just for submitting your entry ... this is a win-win offer ... enter today!	 
More Money Freebies 	More Contests & Sweeps 	

Top Rated Freebies Sites
 other cool freebies sites...  	
Free2Try	 
100's of the Web's best Freebies, Free Samples and Trial Offers!	 
My Freebies	 
Loads & Loads of quality Freebies Free Trials and Samples here!	 
Freebies Quest	 
Filled with loads of freebies and samples for the WHOLE family!	 
Babies Online 	
Loads of baby freebies and samples plus, useful info for moms!	 
Clips Ahoy - Free Clipart!	 
230 categories of clipart freebies to choose from - Awesome site!	 
Top50 Free Sites	 
Ranked list of the Web's Top 50 Freebies and Samples Sites!	 
TopDesktop.Com	 
Super desktop enhancement site 1000's of Free Themes and Savers!	 
Download Free Games	 
Check out this excellent resource for game freebies!	 
Totally Free Stuff	 
Outstanding Freebies site, loads of great free offers and samples!	 
Abstract Fonts - Free Fonts!	 
100's of high quality Fonts for download ... all Free!	 
Just Free Stuff 	
100's of great Freebies in 50 categories - including free samples!	 
Noodan Free Games	 
Hundreds of game freebies for download and online play!	 
#1FreeStuff	 
A flat out awesome Freebies site! Loads of free samples and more!	 
Free Mania	 
Very popular site with tons of cool freebies, samples & much more!	 
Free-n-Cool	 
Cool name...Even cooler Freebies site! Loads of Free Stuff here!	 
Free Original Clip Art	 
1000's of 100% Free Original clip art offers you won't find elsewhere!	 
Freaky Freddies	 
 73 categories of Freebies & Samples on this outstanding site!	 
Only Free Stuff	 
Over 50 categories of the latest and greatest Freebies & Free Samples!	 
FreeChannel	 
34 categories of cool Freebies, samples and lots more!	 
Really Cheap FreeStuff	 
Great Freebies and hilarious reviews. A must visit site!	 
Arcade Nut - Free Games!	 
Loads of really cool FREE games the whole family can play!	 
Webmaster SEO Toolkit	 
Free step-by-step guides to getting a top-10 listing on Google and Yahoo.	 
College Free Stuff 	
Check out this great site for loads of student & everybody freebies!	 
The Free Site	 
Awesome resource for free samples & freebies on the Internet!	 
Daily Freebie	 
Serves up lots of great useful freebies every day!	 
Totally Cool Free Stuff	 
Totally cool is right! Great resource for useful freebies for all.	 
Absolutely Freebies	 
Your source for quality freebies on the Internet...Loads of them!	 
LinkBox.ws	 
Free text link exchange network. Increase your site traffic!	 
SimplyTheBest1 Free Clipart	 
Download over 35.000 clipart images and more for Free!	 
Top Celebs Desktop Themes	 
Packed with 100's of Free celeb desktop theme downloads!	 
Abby's Good Stuff for Free	 
Very well done site with TONS of useful Freebies & Free Samples!	 
Hooked on Freebies	 
Scouring the Web to find you the best freebies & samples available!	 
Killer Freebies	 
Colorful, updated daily and chocked full of cool freebies & samples!	 
Computer Technical Tutorials	 
A free premier directory for computer technology and related tutorials.	 
Dyno Free Game Downloads	 
Loads of FREE game downloads and many you can play online!	 
Your Link Here	 
Want your freebies site listed here? Click above for details.	 
Your Link Here	 
Want your freebies site listed here? Click above for details.	 
More Freebies Sites 	

---------------------------------------------------------------------

Link to Us	 	
Click Here for link options. Thanks!
Webmasters ... For Link Exchange
Info Click Here.	 		
As Seen on NBC NEWS
Click For Story	 	
Copyright Notice	 Terms of Use	 
Privacy Guarantee	 

---------------------------------------------------------------------

Last Updated on 

Search for more freebies on Goggle

Listed on GetWebLink.com

^ Back to Top ^

© 1998 - 2004 Cool Freebie Links
All Rights Reserved
A Dynamic Digital Marketing Network Site

 

 

 

