

Media Search:	 	

Homes & Garden	 	
American Bungalow	Home Systems	
American Style	Home Textiles Today	
Apartments for Rent	Homebuilding and Renovating	
Best Places to Live	HOSPITALITY DESIGN	
Better Homes & Garden	House & Garding	
Builder	House Beautiful	
Building Systems	House Values	
California Fairways	Housing Zone	
Canadian House and Home.	I D	
Canadian Interiors	Inside Housing	
Carolina Fairways	Interior Design	
Carolina Gardener	Interiors and Sources	
Coastal Living	Irrigation Journal	
Commercial Property	IS Design	
Constructech	Kitchen & Bath Design News	
Contract	Kitchen and Bath	
Contract Design	Laminating Design and Technology	
Correctional News	Lebulletin	
Design Build	Living Home	
Dream Homes	Living Room	
Dwell	Log Home Living	
Electronic House	Log Homes Illustrated	
Elle Decor	Metropolis	
Environmental Design & Construction	National Floor Trends	
Fine Gardening	Natural Home	
Fine Homebuilding	Old House Journal	
Fine Woodworking	Organic Gardening	
Floor Covering Installer	Oriac Design Furniture	
Frame magazine	Plan House	
Furniture Today	Qualifier Remodelar	
Garden Gate Magazine	Ready Made Magazine	
Gardeners World	Realestate Book	
Garding	Residential Systems News	
Good Homes	Roofing Contractor	
Good House Keeping	Seasonal Magazine	
Green Industry	Solid Surface Magazine	
Greenhouse Product News	South BC Canada Real Estate	
Handyman	Southern Accents	
Home & Heritage	Sports Turf	
Home Accents Today	Stone World	
Home Arts	This Old House	
Home Automation Magazine	TRADITIONAL HOME	
Home Companion	Veranda	
Home Energy	Wallpaper	
Home Farm	Walls and Ceilings	
Home Fashion Central	Wood Design	
Home Mag	Woodsmith	
Home Power	Woodworking Canada	
Home Retail Network	Workbench	
Home Style	Yard & Garden		
 

 

Adult / Audio & Stereo / Architecture / Automotive / Aviation / Career / Catalogs / Children & Parents / Computer Catalogs / Directories / Electronic Components Catalogs /  Entertainment / Fashion & Beauty / Financial / Food & Beverages / Games / Health / History / Hobbies / Home & Garden / Industrial / Industrial Catalogs / International Magazines / International Newspapers / Internet / Legal  / Life Style / Music / Network News / News Magazines / Newspapers / PC & Software / Pets & Animals / Photo-Lighting / Printing-Imagaing / Publication Companies / Science / Sports & Fitness / Technology / Transportation / Travel / TV Stations / Yellow Pages 	
sales@medialinksnow.com

 

  